NO ./assets/textures/summer.xpm
SO ./assets/textures/summer.xpm
WE ./assets/textures/summer_dark.xpm
EA ./assets/textures/summer_dark.xpm
F ./assets/textures/floor/summer.xpm
C ./assets/textures/ceil/summer.xpm
D ./assets/textures/summerdoor.xpm
L ./assets/textures/summerdoor_locked.xpm
TREE ./assets/sprites/summer_tree.xpm
EXIT ./assets/sprites/summer_portal.xpm

NEXT ./assets/maps/4seasons/map3.cub


1111111111111111111111111111
1X0000000L00000000000000C0T1
1110Q001C1100000001111011111
11111111100000000000000000011111
        1011000001110000000000C111
        100000000110000011111111111
11111111111111011100000010Q01
11110111111111011101010010001
11K00000D00101011100000010001
1111111110000001100000010001
       1C000000000000001100011111111
    11110000110101000000000011111
111111111101010000000T0000001
10000000001100000100000010001
10000000000000000000000001001
100T0000111100010000N00001001
100000001  100110101110000001
1C00000Q1111100000Q1 101000C1
11111111111111111111 11111111

