NO ./assets/textures/spring_2.xpm
SO ./assets/textures/spring_2.xpm
WE ./assets/textures/spring_2_dark.xpm
EA ./assets/textures/spring_2_dark.xpm
F ./assets/textures/floor/spring.xpm
C ./assets/textures/ceil/spring.xpm



1111111111111111111111111
1000000000000000000000001
1000000000000000000000001
1000000000000000000000001
1000000N00000000000000001
1111111110000000000000001
1000000010000000000000001
1000000010000000000000001
1111111111111111111111111
