NO ./assets/textures/spring_2.xpm
SO ./assets/textures/spring_2.xpm
WE ./assets/textures/spring_2_dark.xpm
EA ./assets/textures/spring_2_dark.xpm
F ./assets/textures/floor/spring.xpm
C ./assets/textures/ceil/spring.xpm


111111111111111111  11111
1000000000000000000000001
1000000000000000000000001
1000000000000000000000001
1000000000S00000000000001
1000000000000000000000001
1000000000000000000000001
1000000000000000000000001
1111111111111111111111111
