NO ./sources/textures/3.xpm
SO ./sources/textures/13wall_dark.xpm
WE ./sources/textures/6dark.xpm
EA ./sources/textures/11.xpm   
F ./sources/textures/8darker.xpm
C ./sources/textures/9darker.xpm
D ./sources/textures/reddoor.xpm
EXIT ./sources/textures/exit_txt_1.xpm




        1111111111111111111111111
        10000000011100000X0000001
        1011000001110000000000001
        10010000000000000000000W1
111111111011010000000000000000001
100000000011000000000000111111111
111101111011111011100010010001  
11110111111111011101D11110001
11000000110101011100000010001
10000000000000001100000010001
100000000000000011011110000001
110000011101010111111111100111
11110111 1110101 111111000001
11111111 1111111 111111111111
