NO ./sources/textures/3.xpm
SO ./sources/textures/13wall_dark.xpm
WE ./sources/textures/6dark.xpm
EA ./sources/textures/11.xpm   
F ./sources/textures/floor/13.xpm
C ./sources/textures/floor/13dark.xpm
D ./sources/textures/moriasdoor.xpm




        1111111111111111111111111
        1000000001110000000000001
       11011000001110000000000001
      10000D0000000000000000000W1
111111101011010000000000000000001
100000000011000000000000111111111
111101111011111011100010010001  
11110111111111011101D11111001
11000000110101011101000010001
10000000000000001101D10010001
10000000000000001101010000001
11000001110101011101011110011
11110111 1110101 111111000001
11111111 1111111 111111111111
