NO ./sources/textures/4xxpm/2.xpm
SO ./sources/textures/4xxpm/14dark.xpm
WE ./sources/textures/4xxpm/6dark.xpm
EA ./sources/textures/4xxpm/11.xpm   
F ./sources/textures/4xxpm/9.xpm
C ./sources/textures/4xxpm/9dark.xpm
D ./sources/textures/4xxpm/13dark.xpm
EXIT ./sources/textures/trap.xpm




        1111111111111111111111111
        10000000011100000000000W1
        1011000001110000000000001
        1001000000000000000000001
111111111011010000000000000000001
10000000001100000000D000111111111
111101111011111011100010010001  
11110111111111011101011110001
11000000110101011100000010001
10000000000000001100000010001
100000000000000011011110000001
110000011101010111111111100111
11110111 1110101 111111000001
11111111 1111111 111111111111
