     NO ./sources/textures/north_txt.xpm     
SO     ./sources/textures/south_txt.xpm
 WE   ./sources/textures/west_txt.xpm      
EA  ./sources/textures/east_txt.xpm     
F    187,239,168
    C 139,221,222  
D ./sources/textures/east_txt.xpm
    NEXT ./sources/maps/map.cub
    EXIT ./sources/textures/east_txt.xpm 


        1111111111111111111111111
        10000000001100000000000W1
        1011000001110000000000001
        1001000000000000000000001
111111111011010001110000000000001
10000000001100000111D111111111111
111101111011111011100000010001  1
11110111111111011101010010001
11000000110101011100000010001
10000000000000001100000010001
10000000000000001101010000001
110000011101010111110111100111
11110111 1110101 111111000001
11111111 1111111 111111111111
