NO ./assets/textures/3.xpm
SO ./assets/textures/13wall_dark.xpm
WE ./assets/textures/6dark.xpm
EA ./assets/textures/11.xpm   
F ./assets/textures/floor/13.xpm
C ./assets/textures/floor/13dark.xpm
D ./assets/textures/moriasdoor.xpm
EXIT ./assets/sprites/chest2.xpm




        1111111111111111111111111
        1000000001110000000000001
       11011000001110000000000001
      10000D00000000000X0000000N1
111111101011010000000000000000001
10000000001100000001D11D111111111
111101111011111011010110010001  
11110111111111011101D11111001
11000000110101011101000010001
10000000000000001101D10010001
10000000000000001101000000001
11000001110101011101011110011
11110111 1110101 111111000001
11111111 1111111 111111111111
