NO ./assets/textures/spring_2.xpm
SO ./assets/textures/spring_2.xpm
WE ./assets/textures/spring_2_dark.xpm
EA ./assets/textures/spring_2_dark.xpm
F ./assets/textures/floor/spring.xpm
C ./assets/textures/ceil/spring.xpm
D ./assets/textures/springdoor.xpm
L ./assets/textures/springdoor_locked.xpm
EXIT ./assets/sprites/spring_portal.xpm
TREE ./assets/sprites/spring_tree.xpm



        1111111111111111111111111
        1Q000000C10Q0100000C00001
       1101100T001000100T00000001
      10000D0000011C110000X000W01
111111111011010000000000000000001
10000L000C1100000001D11D111111111
111111111011111011010110Q100Q1  
1111C111111111011101D11D11C01
11Q0000Q1101010111010C0010001
1000T000000000001101D10010C01
1000000000000000CC01000000001
11Q00Q01110101011101C11110111
1111K111 1110101 111111Q000Q1
11111111 1111111 111111111111
