NO ./assets/textures/summer.xpm
SO ./assets/textures/summer.xpm
WE ./assets/textures/summer_dark.xpm
EA ./assets/textures/summer_dark.xpm
F ./assets/textures/floor/summer.xpm
C ./assets/textures/ceil/summer.xpm
D ./assets/textures/summerdoor.xpm
EXIT ./assets/sprites/summer_portal.xpm
CHEST ./assets/sprites/chest.xpm
KEY ./assets/sprites/key.xpm
COIN ./assets/sprites/coin.xpm
NEXT ./assets/maps/map4.cub


11111111111111111111111111111
10000000001100000000000000001
1X1100001D1100000001111011111
11111111100000000000000000011111
        10110000011100000000000111111
        100000000110000011111111111
11111111111111011100000010001
11110111111111011101010010001
11000000D00101011100000010001
1111111110000001100000010001
       10000000000000001100011111111
    11110000110101000000000011111
11111111110101000000000000001
10000000001100000100000010001
10000000000000000000000001001
10000000111100010000N00001001
100000001  100110101110000001
10000000111110000001 10100001
11111111111111111111 11111111

