NO ./assets/textures/winter.xpm
SO ./assets/textures/winter.xpm
WE ./assets/textures/winter_dark.xpm
EA ./assets/textures/winter_dark.xpm   
F ./assets/textures/floor/winter.xpm
C ./assets/textures/ceil/winter.xpm
D ./assets/textures/winterdoor.xpm
EXIT ./assets/sprites/winter_portal.xpm

NEXT ./assets/maps/map.cub

11111111111111111111111111111111111
1000000000110000000110000C0000000W1
10111111101101111101101111111111001
10000000100000000100000000000001001
11110110111110110111110111110111Q01
10000100000000100000000100000001001
10111101111111101111111101111111001
10000001000000000000000100000000001
10111101101111111110111101111110001
10000000001000000000100000000000001
11011111110110111110110111111110X01
10000000000000000100000000000010001
11110111110111110111110111110111111
100001000001000000000001000000D0001
10111101111101111110111101111111001
10000001000001000000100001000000001
11111111111111111111111111111111111
