NO ./assets/textures/11.xpm
SO ./assets/textures/11.xpm
WE ./assets/textures/11darker.xpm
EA ./assets/textures/11darker.xpm
F ./assets/textures/12.xpm
C 143,143,143


                        11111111111111111111111111111111111111111
                        100000100000000000000000000000000000000W1
                        11101010101011101011101110111011101011101
                        10001000101010101000100000101010000000001
                        10101110111110101111111010101110111111111
                        10101010100000000010000010100010100010001
                        10111011111111111010111110101111111010101
                        10101010001000001010000010000000000000101
                        10101010101110111011101011111110111111101
                        10000010101000001000001010100010001000001
                        10101010111111101110111110101111101011101
                        10101000000010000010000000000010000000101
                        11101010111110111010101011101110111111111
                        10101010000000100000101000100000100000001
                        10101110111010111010101111111110101111101
                        10000000001010001010101000000010000010101
                        10111011101110101011111011101110111010101
                        10100010001010101000001000100010001010101
                        10111010101011101111101011101111101010101
                        10100010101000101000100000100010101010001
                        10111010101110101110101011111110111011101
                        10101010100000101000001000100010001010001
                        10101110101111111110101111101110101010101
                        10001000100010000000100010000010101010101
                        10101011101010101111111110111110111010111
                        10101010001010100000000000100000100010001
                        10101011111011111111111110101111111111101
                        10101000101000000000001000101000001000001
                        10101110101111111010111110101010111011111
                        10001000000010000010100010000010100000001
                        10101011111011101010101111111110111111101
                        10000000001000001010000010000000001000001
                        11101010111110101011111010111111101010001
                        10001010100000100000001000100000000010101
                        10000010000000000000000000000000000000001
                        11101010101011101011101110111011101011101
                        10001000101010101000100000101010000000001
                        10101110111110101111111010101110111111111
                        10101010100000000010000010100010100010001
                        10111011111111111010111110101111111010101
                        10101010001000001010000010000000000000101
                        10101010101110111011101011111110111111101
                        10000010101000001000001010100010001000001
                        10101010111111101110111110101111101011101
                        10101000000010000010000000000010000000101
                        11101010111110111010101011101110111111111
                        10101010000000100000101000100000100000001
                        10101110111010111010101111111110101111101
                        10000000001010001010101000000010000010101
                        10111011101110101011111011101110111010101
                        10100010001010101000001000100010001010101
                        10111010101011101111101011101111101010101
                        10100010101000101000100000100010101010001
                        10111010101110101110101011111110111011101
                        10101010100000101000001000100010001010001
                        10101110101111111110101111101110101010101
                        10001000100010000000100010000010101010101
                        10101011101010101111111110111110111010111
                        10101010001010100000000000100000100010001
                        10101011111011111111111110101111111111101
                        10101000101000000000001000101000001000001
                        10101110101111111010111110101010111011111
                        10001000000010000010100010000010100000001
                        10101011111011101010101111111110111111101
                        10000000001000001010000010000000001000001
                        11101010111110101011111010111111101010001
                        10001010100000100000001000100000000010101
                        11111111111111111111111111111111111111111