NO ./assets/textures/spring_2.xpm
SO ./assets/textures/spring_2.xpm
WE ./assets/textures/spring_2_dark.xpm
EA ./assets/textures/spring_2_dark.xpm
F 0,0,0
C 0,0,0



1111111111111111111111111
1000000000000000000000001
1000000000000000000000001
1000000000000000000000001
1000000000000000000000001
1000000000000000000000001
1000000000000000000000001
10000000000000000000000N1
1111111111111111111111111
