NO ./assets/textures/spring_2.xpm
SO ./assets/textures/spring_2.xpm
WE ./assets/textures/spring_2_dark.xpm
EA ./assets/textures/spring_2_dark.xpm
F 255,255,0
C 0,0,0


11111111111111111111111111
100000000000S0000000000001
10000000000000000000000001
10000000000000000000000001
10000000000000000000000001
10000000011111110000000001
1000000001     10000000001
1000000001     10000000001
10000000011111110000000001
10000000000000000000000001
10000000000000000000000001
10000000000000000000000001
11111111111111111111111111