NO ./assets/textures/spring_2.xpm
SO ./assets/textures/spring_2.xpm
WE ./assets/textures/spring_2_dark.xpm
EA ./assets/textures/spring_2_dark.xpm
F ./assets/textures/floor/spring.xpm
C ./assets/textures/ceil/spring.xpm



        1111111111111111111111111
        1000000001000100000000001
       11011000001000100000000001
      100000000001101100000000W01
111111111011010000000000000000001
100000000011000000010110111111111
111111111011111011010110010001  
11110111111111011101011011001
11000000110101011101000010001
10000000000000001101010010001
10000000000000000001000000001
11000001110101011101011110111
11110111 1110101 111111000001
11111111 1111111 111111111111
